1111 1111 1111 1111 1111 1111 1111 1111 1111 1111 1111 1111 11
1111 1111 0000 0000 0000 0000 0001 1000 0000 0011 1111 1111 11
1111 1111 0000 0000 0000 0000 0001 1000 0000 0111 1111 1111 11
1111 1111 0000 0000 0000 0000 0001 1000 0000 0111 1111 1111 11
1111 1111 0000 0000 0000 0000 0001 1000 0000 1111 1111 1111 11
1111 1111 0000 0000 0000 0000 0001 1000 0001 1111 1111 1111 11
1111 1111 0000 0000 0000 0000 0001 1000 0011 1111 1111 1111 11
1111 1111 0000 0000 0000 0000 0001 1000 0011 1111 1111 1111 11
1111 1111 0000 0000 0000 0000 0001 1000 0001 1111 1111 1111 11
1111 1111 0000 0000 0000 0000 0000 0000 0000 1111 1111 1111 11
1111 1111 0000 0000 0000 0000 0000 0000 0000 0011 1111 1111 01
1111 1111 0000 0000 0000 0000 0000 0000 0000 0000 1111 1110 01
1111 1111 0000 0000 0000 0000 0000 0000 0000 0000 0111 1100 01
1111 1111 0000 0000 0000 0000 0000 0000 0000 0000 0001 1000 01
1111 1111 0000 0000 0000 0000 0000 0000 0000 0000 0000 0000 01
1111 1111 0000 0000 0000 0000 0000 0000 0000 0000 0000 0000 01
1111 1111 0000 0000 0000 0000 0000 0000 0000 0000 0000 0000 01
1111 1111 0000 0000 0000 0000 0000 0000 0000 0000 0000 0000 01
1000 0000 0000 0000 0000 0000 0000 0000 0000 0000 0000 0000 01
1000 0000 0000 0000 0000 0000 0001 1000 0000 0000 0000 0000 01
1000 0000 0000 0000 0000 0000 0001 1000 0000 0000 0000 0000 01
1000 0000 0000 0000 0000 0000 0001 1000 0000 0000 0000 0000 01
1000 0000 0000 0000 0000 0000 0001 1000 0000 0000 0000 0000 01
1000 0000 0000 0000 0000 0000 0001 1000 0000 0000 0000 0000 01
1000 0000 0000 0000 0000 0000 0001 1000 0000 0000 0000 0000 01
1000 0000 0000 0000 0000 0000 0001 1000 0000 0000 0000 0000 01
1000 0000 0000 0000 0000 0000 0001 1000 0000 0000 0000 0000 01
1000 0000 0000 0000 0000 0000 0001 1000 0000 0000 0000 0000 01
1000 0000 0000 0000 0000 0000 0001 1000 0000 0000 0000 0000 01
1000 0000 0000 0000 0000 0000 0001 1000 0000 0000 0000 0000 01
1000 0000 0000 0000 0000 0000 0001 1000 0000 0000 0000 0000 01
1000 0000 0000 0000 0000 0000 0001 1000 0000 0000 0000 0000 01
1000 0000 0000 0000 0000 0000 0001 1000 0000 0000 0000 0000 01
1000 0000 0000 0000 0000 0000 0001 1000 0000 0000 0000 0000 01
1000 0000 0000 0000 0000 0000 0001 1000 0000 0000 0000 0000 01
1000 0400 0000 0000 0000 0000 0001 1000 0000 0000 0000 0000 01
1000 0000 0000 0000 0000 0000 0001 1000 0000 0000 0000 0000 01
1000 0000 0000 0000 0000 0000 0001 1000 0000 0000 0000 0000 01
1000 0000 0000 0000 0000 0000 0001 1000 0000 0000 0000 0000 01
1000 0000 0000 0000 0000 0000 0001 1000 0000 0000 0000 0000 01
1000 0000 0000 0000 0000 0000 0001 1000 0000 0000 0000 0000 01
1000 0000 0000 0000 0000 0000 0001 1000 0000 0000 0000 0000 01
1111 1111 1111 1111 1000 0000 0001 1000 0000 0000 0000 0000 01
1000 0000 0000 0000 0000 0000 0001 1000 0000 0000 0000 0000 01
1000 0000 0000 0000 0000 0000 0001 1000 0000 0000 0000 0000 01
1000 0000 0000 0000 0000 0000 0001 1000 0000 0000 0000 0000 01
1000 0000 0000 0000 0000 0000 0001 1000 0000 0000 0000 0000 01
1000 0000 0000 0000 0000 0000 0001 1000 0000 0000 0000 0000 01
1000 0000 0000 0000 0000 0000 0001 1000 0000 0000 0000 0000 01
1111 1111 1111 1111 1111 1111 1111 1111 1111 1111 1111 1111 11