11111111111111111111111111111111111111111111111111
11111111000000000000000000011000000000111111111111
11111111000000000000000000011000000001111111111111
11111111000000000000000000011000000001111111111111
11111111000000000000000000011000000011111111111111
11111111000000000000000000011000000111111111111111
11111111000000000000000000011000001111111111111111
11111111000000000000000000011000001111111111111111
11111111000000000000000000011000000011111111111111
11111111000000000000000000000000000011111111111111
11111111000000000000000000000000000000111111111101
11111111000000000000000000000000000000001111111001
11111111000000000000000000000000000000000111110001
11111111000000000000000000000000000000000001100001
11111111000000000000000000000000000000000000000001
11111111000000000000000000000000000000000000000001
11111111000000000000000000000000000000000000000001
11111111000000000000000000000000000000000000000001
10000000000000000000000000000000000000000000000001
10000000000000000000000000011000000000000000000001
10000000000000000000000000011000000000000000000001
10000000000000000000000000011000000000000000000001
10000000000000000000000000011000000000000000000001
10000000000000000000000000011000000000000000000001
10000000000000000000000000011000000000000000000001
10000000000000000000000000011000000000000000000001
10000000000000000000000000011000000000000000000001
10000000000000000000000000011000000000000000000001
10000000000000000000000000011000000000000000000001
10000000000000000000000000011000000000000000000001
10000000000000000000000000011000000000000000000001
10000000000000000000000000011000000000000000000001
10000000000000000000000000011000000000000000000001
10000000000000000000000000011000000000000000000001
10000000000000000000000000011000000000000000000001
10000400000000000000000000011000000000000000000001
10000000000000000000000000011000000000000000000001
10000000000000000000000000011000000000000000000001
10000000000000000000000000011000000000000000000001
10000000000000000000000000011000000000000000000001
10000000000000000000000000011000000000000000000001
10000000000000000000000000011000000000000000000001
11111111111111111000000000011000000000000000000001
10000000000000000000000000011000000000000000000001
10000000000000000000000000011000000000000000000001
10000000000000000000000000011000000000000000000001
10000000000000000000000000011000000000000000000001
10000000000000000000000000011000000000000000000001
10000000000000000000000000011000000000000000000001
11111111111111111111111111111111111111111111111111